   R         1920 1080
NO ./kdo/leo.xpm
SO ./kdo/jb.xpm
EA                             ./kdo/astrid.xpm
               WE ./kdo/nous.xpm
S    kdo/dressing2.xpm                    
E                  kdo/voleur.xpm
D  kdo/talon.xpm
M kdo/champ.xpm
F   100, 100, 100                           
C 0, 0,                            255
SK textures/space.xpm

11111111111111111  111   111
100001d2000000001111d1111d1111
1E0000000000000000000000000001
1ddddddddddd000011110111111d11
11111111111111011  101    111
             1q1   101
             111   101111
              111111000d1
              1d000000011
               111111001
                  1d0001
                   11001
         111        1001
         1d1        100111
         101111111111100d1
         10000000000000011
1101     1111100111111111           
1d01         100111111
 101         1000000d1
 101         111100111
 101             1001111
 101             10000d1
  000000000000000000111   
            111111111
