
   R         1920 1080
NO ./kdo/leo.xpm
SO ./kdo/jb.xpm
EA                             ./kdo/astrid.xpm
               WE ./kdo/nous.xpm
S    kdo/dressing2.xpm                    
E                  kdo/voleur.xpm
D  kdo/talon.xpm
M kdo/champ.xpm
F   100, 100, 100                           
C 0, 0,                            255
SK textures/space.xpm
G textures/gun.xpm

                             1111111111111
     111111                  1d000022200m1
     1d0001      11111111111111110000000011111
     1111011     10000000000010000000000010001
     1000011     10000000000000020000000000001
     1m00001     1000000000001000000000001d001
     11111011111 10001111111110000000000011111
     10000000001 10001       1000000000001
     1000000000111000111     1111110111111
     10000000001000000m1         10001
     1000000000001111111         10001
     10000000001000000d1         10001
111111000000000111111111         10001
1d00110000000001                 10001
1110111111011111            111111000111
1m001   1d001               1100000e0001
11011   11001               100111000111
100011111d001               1001110001
100e1d0011001               1d01110001
1000000010001               1111110001
100010001d001                    10001
1000111111011111                1110111               1111111111
100011d000000001           111111000001111111         1m00000001
1000110000000001           10000000e000000011         1000000001
1000110000000001           1000000000000000111111111111000020001
1000010000000001           100e000000002220010000000001000000001
1000000000000001           10000000000000000000000000000e0000001
1000010000000001           1e001000000000001d1000000001000020001
1011110000000001           1000100000000000111100001111000000001
101d110000011111           100d100000000000111110011  1000000001
100011d0000000m1           11111100000111111   1001   1000000001
1000111111011111                1110111        1001   111d11m111
10e011d11m001                    10001         1001     111111
1000110111001                    10001         1001
1000100010001                    10001         1001 111111111
1000000010e01                    10e01         100111d1d1m1d11
1000100010001                    10001         100010000000001
100011d110001                    10001         10000000e000001
10001111100011111111111111       10001         100010000000001
100000000000000001d000000111     10e01         111111d1d1m1d11
1111000000000000000000000001     10001              111111111
1d00001m10000000010000000111     10001
11111111111111111101111111       10001
         1d1001100001       111111101111111
         100001001111       1000m1000100001
         11100000111        10e000000000e01
           1110111          100001000100001
            1001            1000010001d0001
            1d11            111111000111111
            1111            1000m10001d0001
                            10E0000000000e1
                            1000010001d0001
                            111111000111111
                            1d111000001d1d1
                            100022222200001
                            10000000000e001
                            111111111111111
