R 800 600
NO ./textures/colorstone.xpm
SO ./textures/greystone.xpm
WE textures/redbrick.xpm
EA textures/wood.xpm
S ./textures/barrel.xpm
F 220,100,0
C 225,30,0

        1111111111111111111111111
        1000000000110000000222221
        1011000001110000002222221
        1001000000000000000222221
111111111011000001110000000000001
100000000000000001110111111111111
11110111111111011100000010001
11110111111111011101010010001
11000000110101011100000020001
10002000000000001100000010001
10000000000000000001010010001
11000001110101011111011110N0111
11110111 1110101 101111010001
11111111 1111111 111111111111
