C 0,0,255
R 801 601
NO ./textures/wall.xpm
SO ./textures/bricks.xpm
EA                             ./textures/cracked.xpm
               WE ./textures/stone2.xpm
S ./textures/pillar.xpm                
   F    100,255,00


        1111111111111111111111111
        1000000000112222222222221
        1011000001112222222222221
        10010000000E2222222222221
111111111011000001122222222222221
10000000010000011101111111111111
11110111111111011100000010001
11110111111111011101010010001
11000000110101011100000010001
10002000000000001100000000001
10000000000000001101010010001
1100000111010101110101101000111
11110111011101010101111010001
11111111011111110111111110001
10000000000000000000000000001
11111111111111111111111111111
