   R         2000 20000000

NO ./textures/bonus.xpm
SO ./textures/bonus3.xpm
EA                             ./textures/bonus4.xpm
               WE ./textures/bonus2.xpm
S    textures/barrel.xpm                    
F   100, 100, 100                           
C 0, 0,                            255

111111111
1101
1001
1S01
1111
